11111111111111111111
100000000C0000000C01
100E0000000000000001
10000C01111111111111
10000000000000000P01
11111111111111111111
