11111111111111111111
10000000000001000001
1000000C000001000011
1000E000000001000001
10000000000000000001
10000001111111111111
10000000000000000001
10000011111000000001
10000000P00001111441
11111111111111111111
