11111111111111111111
100E0000000001000001
10000000000001000011
11111111111011000001
1000000C000000000001
10000001111111111111
100C0000000000000001
10000011111001000001
100000000000011110P1
11111111111111111111
