11111111111111111111
100000000C0001000C01
10000000000001000011
100E0000000001000001
10000000000000000001
10000C01111111111111
10000000000000000001
10000011111000000P01
10000000000000000001
11111111111111111111
