1111111111111111111111111111111111111111
1000000P000010C00010000000000E10C0000001
1000100000000001001011100101001000000001
1000000000010000001001000111111010110101
1010000000000000001101000000100000000001
10100010C0000010001100000000100111111101
1000000000000000001001111000100100000001
10C0100000000100001001000100000000000001
1111110011111111111111111111100111111111
1000000000000000001000000000000000000001
1010011110010010001001111111111111111001
101001CC10010010001001000000000000001001
1010010010010010001001011111111111101001
1C10010010010010000001010000000000101001
101001001001001000000101C000000010101001
1010010010010010001001011111111110101001
101001001001CC10001001000000000000101001
1010010010011110001001111111111111101001
1000000000000000001000000000000000000001
1111111111111111111111111111111111111111
